%%%%%%%
%     %
% %bP %
% B B%%
%%.B %%
% b .%%
%    %%
%%%%%%%