%%%%%%%%
%%%   %%
%.Pb  %%
%%% b.%%
%.%%b %%
% % . %%
%b Bbb.%
%   .  %
%%%%%%%%
